亲	親
𤨏	瑣
盖	蓋	
靑	青
秊	年
洤	泉
𩔜	頌
藂	叢
朖	朗
㓝	刑
萠	萌
驎	麟
湶	泉
飮	飲
唇	脣
尙	尚
𠛱	列
偒	蕩
精	精
万	萬
嵗	歲
毌	貫
楼	樓
争	爭
囘	回
峯	鋒
乕	虎
郞	郎
詺	名
𣧑	凶
濭	溘
淸	清
顔	顏
軄	職
朙	明
𢅷	蔽
矦	侯
亰	京
娄	婁
㢕	廱
眀	明
亖	四
冝	宜
鄕	郷
莭	節
儿	兒
内	內
脇	脅
巻	卷
顕	顯
竜	龍
従	從